11 12
############
#  S       #
########## #
#          #
#          #
#          #
#          #
#          #
#          #
#         T#
############